#####B  ############
 # #### ##         #
 # #### ########## #
 # #### # ######## #
 # #### #          #
   #### # ##### ## #
 ###### # #   # ## #
 ###### # # # # ## #
 ###### # # # # ####
      # # # # #    #
 #### # # # # # ####
 #### #   # # # ## #
   ## ##### # # ## #
## ##       # # ## #
## ## #######   ## #
##    ####### # ## #
#####         #### #
############# #### #
#                  A
####################
