##################A#
### ##### ######## #
### ##### ######   #
#   #####       # ##
#B# ########### # ##
### ######        ##
### ############# ##
##  #############  #
## #############   #
##      ###        #
####### ### ########
#######     ########
####################