#A#########################
# ########## ##### ########
#         ##     # ###### #
######### ###### #      # #
#####     ###### ###### # #
##### ########   #####  # #
##### ######## ####### ## #
##    ####     # ##### ## #
## ####### ##### ##### ## #
##                        #
######################## ##
#####################    ##
##################### #####
#####################     #
######################### #
#########################B#